1111111
100P011
1001C01
1001011
1001011
100E111
100P111
1111111
