1111111
110P011
1E10C11
1110011
1C00C11
1111111
