1111111
110P111
1100011
11C1101
1101101
11C1101
1101111
1000011
1001011
1000111
1000E11
1111111
