1111111
1111P01
1110C01
1000C01
1000C01
1000E01
1111111
