1111111
100P011
1E00C11
1110011
1C00C11
1111111
